99999999999999999
90222222222222209
90012121212121009
92222222222222229
92121212121212129
92222222222222229
92121212121212129
92222222222222229
92121212121212129
90222222222222209
90012121212121009
99999999999999999