99999999999999999
90022222222222009
90121212121212109
92222222222222229
92121212121212129
92222222222222229
92121212121212129
92222222222222229
92121212121212129
92222222222222229
90121212121212109
90022222222222009
99999999999999999